@@@@@@@@@@@@@
@@@@[@@@@@@@@
@@@@][@@@@@@@
@][{¿[@@@@@@@
@]#[!*}@@@@@@
{¿¿}Ç+@@@@@@@
@!(?@&$@@@@@@
@&-@%)[@@@@@@
@%*@]-¡[@@@@@
{:$].@+}@@@@@
@!)#.$%?@@@@@
@Ç+.)#>@@@@@@
@@Ç(ª+.$@@@@@
@@Ç-Ç-Ç[@@@@@
@@@,@,@¡[@@@@
@@@@@@@¡[@@@@
@@@@@@@@+[@@@
@@@@@#@%+[@@@
@@@@@][]:+[@@
@@@@{¿#.-¡[@@
@@@@@!+.-@¡[@
@@@@@Ç(-@@¡[@
@@@@@@,,@@@¡[
@@@@@@@@@@@¡@