20 80
ªªªªªªªªªªªªªªªªªªªª
ªªªªªªªªªªªªªªªªªªªª
ªªªªªªªªªªªªªªªªªªªª
ªªªªªªªªªªĕĕªªªªªªªª
ªªªªªªªªª³ß¼ªªªªªªªª
ªªªªªªªªª³Ũß¼ªªªªªªª
ªªĕªªªªª³ŨßŨ¼ªªªªªªª
ªª³¼ªªªª³ŨŨŨŨ¼ĕªªªªª
ª³Ũ¼ªªª³ŨŨŨŨŨß¼ªªªªª
ª³ŨŨ¼ª³ĕŨŨŨŨŨŨŨ¼ªªªª
¹ŨŨŨŨ¼³ŨŨŨŨŨŨŨŨȅªªªª
ªŨŨŨŨŨŨŨŨŨŨŨŨŨŨæªªªª
¹ŨŨŨŨ©ŨŨŨŨŨŨŨŨŨȅªªªª
ªŨ©©©ôöŨŨŨŨŨŨªŨéªªªª
¹¬øøø0ŨŨŨŨŨŨŨŨéªªªªª
ªŨóøøø0Ũ©ŨºŨºŨéªªªªª
¹Ũ¿øøøòôöéèéèéªªªªªª
ªŨô°øø°@öéªëªëªªªªªª
¹¿õóøõóõéªªªªªªªªªªª
ªŨçŨóõŨçéªªªªªªªªªªª
¹ŨŨŨ¬ŨŨéªªªªªªªªªªªª
ªŨŨŨôöŨæªªªªªªªªªªªª
¹ŨŨôõŨŨ²ªªªªªªªªªªªª
ªŨŨ©éŨŨæªªªªªªªªªªªª
ªßŨçºŨŨ²ªªªªªªªªªªªª
ª¹ŨŨéèŨéªªªªªªªªªª´ª
ªßŨéªèæªªªªªªªªªª³²ª
ª³Ũ²ªª¤¼ªªªªªªªªªéæª
¹ŨŨ²ª¹Ũ²ªªªªªªªª³Ũ¼ª
ªßŨéªªèæªªªªªªªª¹ŨŨ²
¹Ũæªªªè¼ªªªªªªªª¤Ũæª
ªßŨ²ªªªè¼ªªªªªªª³ŨŨ²
¹Ũéªªªªè¼ªªªªªª¹ŨŨæª
ªßæªªªªª¤¼ªªªªªª¤ŨŨ²
¹Ũ²ªªªª¹Ũ¼ªªªªª¹ŨŨæª
ªßéªªªªªèŨ¼ªªªªª¤ŨŨ²
ÉŨ²ªªªªª¤Ũ¼ªªªª³ŨŨéª
ªªèªªªªª¹ªŨŨªªª¹Ũºëª
ªªËªªªªª¤Ũæªªªªºéëªª
ªªªªªªªª¹Ũº¼ªªª³ëªªª
ªªªªªªªª¤éè¼ªª³éªªªª
ªªªªªªªª³ŨªŨ¼´³éªªªª
ªªªªªªª³Ũ²¹Ũßß²ªªªªª
ªªªªªªª¹ŨŨªŨŨŨéªªªªª
ªªªªªªªŨŨª¹ŨŨæªªªªªª
ªªªªªªª³Ũ²ªŨŨŨ²ªªªªª
ªªªªªª³ŨŨª¹ŨŨæªªªªªª
ªªªªªª³ŨŨ²ªŨŨŨ²ªªªªª
ªªªªª³ŨŨŨª³ŨŨæªÈªªªª
ªªªªª¹ŨŨŨ¼³ŨŨŨŨ²ªªªª
ªªªªª¤ŨŨŨŨŨŨŨŨß²ªªªª
ªªªªª³ŨŨŨŨŨŨŨŨŨæªªªª
ªªªª³ŨŨªŨŨŨŨŨªŨ¼ªªªª
ª´ªª³ŨŨŨŨŨŨŨŨŨŨŨ¼ªªª
¹Ũ´³ŨªŨŨŨŨŨŨŨŨŨŨ²ªªª
ªŨŨßŨŨŨŨŨéèŨŨŨŨŨæªªª
ÉëèŨŨŨŨŨæªèŨŨŨºŨ¼ªªª
ªªª¤èŨŨŨŨ²ª¤ŨŨŨèŨ²ªª
ªª¹éèŨŨŨæª¹ŨŨæªèæªªª
ªªªëªŨªŨŨ¼ª¤ŨŨ²ªè²ªª
ªªªª¹ŨŨŨŨ¼³ŨŨæªªëªªª
ªªªªªèŨŨŨŨŨŨŨŨ²ªªªªª
ªªªªªèŨŨŨŨŨªŨæªªªªª¶
ªªªªªªŨŨŨŨŨªªŨ¼ªªªª¶
ªªªªª¹ŨŨŨŨŨªŨŨ²ªªª¶i
ªªªªªªèŨŨŨŨŨªŨæªªª¶i
ªªªªªªŨªªŨŨŨŨŨ²ªª¶ii
ªªªªªª³ŨŨŨŨŨŨŨæªª¶ii
ªªªªª¹ŨŨŨººŨŨº²ª¶iii
ªªªªªª¤ŨŨéëŨŨŨëª¶iii
ªªªªª¹ŨŨéªªŨŨªª¶iiii
ªªªªªª¤ŨéªªªŨªª¶iiii
ªªªªª¹ŨéªÐªëªª¶iiiii
ªªªªªª¤éª¶±ªŨ±¶iiiii
ªªªªª¹éª¶Ũ±ùŨ±iiiiii
ªªªªªªëª¶åå±×å±iiiii
ªªªªªªª¶áÁà±áà±iiiii
ªªªªªªª¶á»»àáŨà±iiii
ªªªªªª¶áŨ»±±Á±à±iiii
ªªªªªª¶á¶iiiiiªà±iii
