20 80
ªªªªªªªªªªªªªªªªªªªª
ªªªªªªªªªªªªªªªªªªªª
ªªªªªªªªªªªªªªªªªªªª
ªªªªªªªªªªĕĕªªªªªªªª
ªªªªªªªªªėŨēªªªªªªªª
ªªªªªªªªªėŨŨēªªªªªªª
ªªĕªªªªªėŨŨŨēªªªªªªª
ªªėēªªªªėŨªŨŨēĕªªªªª
ªėŨēªªªėŨŨŨŨŨŨēªªªªª
ªėŨŨēªėĕŨŨŨŨŨŨŨēªªªª
ȇŨªŨŨēėŨŨŨŨŨŨŨŨȅªªªª
ªŨŨŨŨŨŨŨŨªŨŨŨŨŨŨªªªª
ȇŨŨŨŨªŨŨŨŨŨŨªŨªȅªªªª
ªŨªªªªªŨŨªŨŨŨªŨéªªªª
ȇªªªªªŨŨªŨŨŨŨŨéªªªªª
ªŨªªªªªŨªŨŨŨŨŨéªªªªª
ȇŨªªªªªªªéèéèéªªªªªª
ªŨªªªªªªªéªëªëªªªªªª
ȇªªªªªªªéªªªªªªªªªªª
ªŨªŨªªŨªªªªªªªªªªªªª
ȇŨŨŨªŨŨªªªªªªªªªªªªª
ªŨŨªªªŨŨªªªªªªªªªªªª
ȇŨŨªªŨŨŨªªªªªªªªªªªª
ªŨŨªªŨŨŨªªªªªªªªªªªª
ªŨŨªŨŨŨŨªªªªªªªªªªªª
ªŨŨŨŨŨŨŨªªªªªªªªªªŨª
ªŨŨŨªŨŨªªªªªªªªªªŨŨª
ªŨŨŨªªŨŨªªªªªªªªªŨŨª
ȇŨŨŨªŨŨŨªªªªªªªªŨŨŨª
ªŨŨŨªªŨŨªªªªªªªªŨŨŨŨ
ȇŨŨªªªŨŨªªªªªªªªŨŨŨª
ªŨŨŨMMMŨŨMMMMMMMŨŨŨŨ
ȇªŨªªªªŨŨªªªªªªŨŨŨŨª
ªŨŨªªªªªŨŨªªªªªªŨŨŨŨ
ȇŨŨªªªªŨŨŨªªªªªŨŨŨŨª
ªŨŨªªªªªŨŨŨªªªªªŨŨŨŨ
ȇŨªªªªªªŨŨŨªªªªŨŨŨŨª
ªªŨªªªªªŨªŨŨªªªŨŨŨŨª
ªªŨªªªªªŨŨŨªªªªŨŨŨªª
ªªªªªªªªŨŨŨŨªªªŨŨªªª
ªªªªªªªªŨŨŨŨªªŨªªªªª
ªªªªªªªªŨŨªŨŨŨŨªªªªª
ªªªªªªªŨŨŨŨŨŨŨŨªªªªª
ªªªªªªªŨŨŨªŨªŨŨªªªªª
ªªªªªªªŨŨªŨŨŨŨªªªªªª
ªªªªªªªŨŨŨªŨŨŨŨªªªªª
ªªªªªªŨŨŨªŨŨŨŨªªªªªª
ªªªªªªŨªŨŨªŨŨŨŨªªªªª
ªªªªªŨŨŨŨªŨªŨŨªŨªªªª
ªªªªªŨŨŨŨŨŨŨŨŨŨŨªªªª
ªªªªªŨŨŨŨŨŨŨŨŨŨŨªªªª
ªªªªªŨŨŨŨŨŨŨŨŨŨŨªªªª
ªªªªŨŨŨªŨŨŨŨŨªŨŨªªªª
ªŨªªŨŨŨŨŨŨŨŨŨŨŨŨŨªªª
ŨŨŨŨŨªŨŨŨŨŨŨŨŨŨŨŨªªª
ªŨŨŨŨŨŨŨŨŨŨŨŨŨŨŨŨªªª
ŨŨŨŨŨŨŨŨŨªŨŨŨŨŨŨŨªªª
ªªªªŨŨŨŨŨŨªŨŨŨŨŨŨŨªª
ªªŨŨŨŨŨŨŨªŨŨŨŨªŨŨªªª
ªªªŨªŨªŨŨŨªŨŨŨŨªŨŨªª
ªªªªŨŨŨŨŨŨŨŨŨŨªªŨªªª
ªªªªªŨŨŨŨŨŨŨŨŨŨªªªªª
ªªªªªŨŨŨŨŨŨªŨŨªªªªªª
ªªªªªªŨŨŨŨŨªªŨŨªªªªª
ªªªªªŨŨŨŨŨŨªŨŨŨªªªªª
ªªªªªªŨŨŨŨŨŨªŨŨªªªªª
ªªªªªªŨªªŨŨŨŨŨŨªªªªª
ªªªªªªŨŨŨŨŨŨŨŨŨªªªªª
ªªªªªŨŨŨŨŨªŨŨŨŨªªªªª
ªªªªªªŨŨŨŨŨŨŨŨŨªªªªª
ªªªªªŨŨŨŨªªŨŨªªªªªªª
ªªªªªªŨŨŨªªªŨªªªªªªª
ªªªªªŨŨŨªªªŨªªªªªªªª
ªªªªªªŨŨªªªªŨªªªªªªª
ªªªªªŨŨªªªªªŨªªªªªªª
ªªªªªªŨªªŨŨªªŨªªªªªª
ªªªªªªªªŨŨŨªŨŨªªªªªª
ªªªªªªªªŨªªŨŨªŨªªªªª
ªªªªªªªŨªªªŨªªªªªªªª
ªªªªªªªªªªªªªªªªªªªª